Король Ночи → Король Тьмы
Вестерос → Западные земли
Дом Старков → Клан Камневых
Арья Старк → Анна Камнева
Джон Сноу → Иван Снегов
Санса Старк → Соня Камнева
Бран Старк → Борис Камнев
Эддард Старк → Эдуард Камнев
Кейтилин Старк → Катерина Камнева
Робб Старк → Роберт Камнев
Дом Ланнистеров → Клан Львовых
Серсея Ланнистер → Серафима Львова
Джейме Ланнистер → Джеймс Львов
Тайвин Ланнистер → Теодор Львов
Дейнерис Таргариен → Дана Огнева
Дом Таргариенов → Клан Огневых
Белые ходоки → Ледяные тени
Дети леса → Лесные чада
Первые люди → Древние люди
Ходор → Вратко
Мира → Мирена
Теон Грейджой → Тимофей Волнов
Дом Грейджой → Клан Волновых
Железнорождённые → Морские волки
Последний Очаг → Крайний Очаг
Дом Амбер → Клан Угловых
Визерион → Вихорь
Рейгаль → Ростислав
Богороща → Древняя роща
Долгая ночь → Долгая Тьма
Эпоха Рассвета → Эпоха Зари
Драконье стекло → Пламенное стекло
Валирийская сталь → Пламенная сталь
Стена → Барьер льда
Винтерфелл → Зимоград
Север → Северные земли
Драконий Камень → Остров Пламени
Восточный дозор → Восточный страж
За Стеной → За Барьером
Трёхглазый ворон → Трёхокий коршун
Битва за Винтерфелл → Битва за Зимоград
Королевская Гавань → Императорская Бухта
Железный трон → Золотой диван
Семь Королевств → Семь царств
Древние боги → Древние боги
Варги → Оборотни
Армия мертвецов → Армия призраков